%%%%%%%%%
%.    ..%
%       %
%   P   %
%%%%%%%%%
%.%.   .%
%%%%%%%%%
